929,930,930,930,930,930,930,930,930,930,930,930,930,930,930,930,930,930,930,931
872,873,873,873,873,873,873,873,873,873,873,873,873,873,873,873,873,873,873,874
872,873,873,873,873,873,873,873,873,873,873,873,873,873,873,873,873,873,873,874
65,65,65,65,65,65,65,65,65,65,65,65,65,65,65,65,65,65,65,65
65,65,65,65,65,65,65,65,65,65,65,65,65,65,65,65,65,65,65,65
65,65,65,65,65,65,65,65,65,65,65,65,65,65,65,65,65,65,65,65
65,65,65,65,65,65,65,65,65,65,65,65,65,65,65,65,65,65,65,65
65,65,65,65,65,65,65,65,65,65,65,65,65,65,65,65,65,65,65,65
65,65,65,65,65,65,65,65,65,65,65,65,65,65,65,65,65,65,65,65
65,65,65,65,65,65,65,65,65,65,65,65,65,65,65,65,65,65,65,65
65,65,65,65,65,65,65,65,65,65,65,65,65,65,65,65,65,65,65,65
65,65,65,65,65,65,65,65,65,65,65,65,65,65,65,65,65,65,65,65
65,65,65,65,65,65,65,65,65,65,65,65,65,65,65,65,65,65,65,65
65,65,65,65,65,65,65,65,65,65,65,65,65,65,65,65,65,65,65,65
65,65,65,65,65,65,65,65,65,65,65,65,65,65,65,65,65,65,65,65
65,65,65,65,65,65,65,65,65,65,65,65,65,65,65,65,65,65,65,65
65,65,65,65,65,65,65,65,65,65,65,65,65,65,65,65,65,65,65,65
65,65,65,65,65,65,65,65,65,65,65,65,65,65,65,65,65,65,65,65
65,65,65,65,65,65,65,65,65,65,65,65,65,65,65,65,65,65,65,65
65,65,65,65,65,65,65,65,65,65,65,65,65,65,65,65,65,65,65,65
