936,937,937,937,937,937,937,937,937,937,937,937,938
879,880,880,880,880,880,880,880,880,880,880,880,881
879,880,880,880,880,880,880,880,880,880,880,880,881
879,1151,1151,1151,1151,1151,1151,1151,1151,1151,1151,1151,881
879,1151,1151,1151,1151,1151,1151,1151,1151,1151,1151,1151,881
879,1151,1151,1151,1151,1151,1151,1151,1151,1151,1151,1151,881
879,1151,1151,1151,1151,1151,1151,1151,1151,1151,1151,1151,881
879,1151,1151,1151,1151,1151,1151,1151,1151,1151,1151,1151,881
879,1151,1151,1151,1151,1151,1151,1151,1151,1151,1151,1151,881
876,875,875,875,875,875,150,875,875,875,875,875,878
