929,930,930,930,930,930,930,930,930,930,930,930,930,930,930,930,930,930,930,930,930,930,930,930,931
872,873,873,873,873,873,873,873,873,873,873,873,873,873,873,873,873,873,873,873,873,873,873,873,874
872,873,873,873,873,873,873,873,873,873,873,873,873,873,873,873,873,873,873,873,873,873,873,873,874
872,1151,1151,1151,1151,1151,1151,1151,1151,1151,1151,1151,1151,1151,1151,1151,1151,1151,1151,1151,1151,1151,1151,1151,874
872,1151,1151,1151,1151,1151,1151,1151,1151,1151,1151,1151,1151,1151,1151,1151,1151,1151,1151,1151,1151,1151,1151,1151,874
872,1151,1151,1151,1151,1151,1151,1151,1151,1151,1151,1151,1151,1151,1151,1151,1151,1151,1151,1151,1151,1151,1151,1151,874
491,1151,1151,1151,1151,1151,1151,1151,1151,1151,1151,1151,1151,1151,1151,1151,1151,1151,1151,1151,1151,1151,1151,1151,874
872,1151,1151,1151,1151,1151,1151,1151,1151,1151,1151,1151,1151,1151,1151,1151,1151,1151,1151,1151,1151,1151,1151,1151,874
872,1151,1151,1151,1151,1151,1151,1151,1151,1151,1151,1151,1151,1151,1151,1151,1151,1151,1151,1151,1151,1151,1151,1151,874
869,868,868,868,868,868,868,868,868,868,868,868,868,868,868,868,868,868,868,868,868,868,868,868,871
